NO ./texture/north.xpm
SO ./texture/south.xpm
WE ./texture/west.xpm
EA ./texture/east.xpm
F 220,100,1
C 225,30,0
        1111111111111111111111111
        1000000000110000000000001
        1011000001110000000000001
        1001000000000000000010001
111111111011000001110000000000001
10000000111111111111110111111111111
11110111            100000010111
11110111111111111111010010001
11000000110101011100000010001
10000000000000001100000010001
10000000000000001101010000011
11000001110101011111011100W111
11110111 1110101 11111010001
11111111 1111111 111111111111
