NO ./texture/ray/no.xpm
SO ./texture/ray/so.xpm
WE ./texture/ray/we.xpm
EA              ./texture/ray/ea.xpm

F 0,50,12




C 0,100,0

        111111111111111111111111
        1000000000110000000000001    
        1011000001110000000000001
        1001000000000000000000001
111111111011000001110000000000001
100000000011000001110111100111111 111
111101111111110111000000000011    101
111101111111110111000000000011    111
110000001101010111000111B1111
10000000000000000000010000001
100000000000000000000B0000001
110000011101010111B101110000111
11110111111101011101111000001
11111111111111111111111BB1111
         111111111111110011111111
        1000000000110000000000001
        1011000001110000000000001
        1001000000000000000000001
111111111011000001110000000000001
1E0000000011000001110111100111111
11110111111111011100000000001
11110111111111011100000000001
110000001101010111000111B1111
10000000000000000000010000001
100000000000000000000B0000001
11000001110101011111011100001
11110111 1110101 101111000001
11111111 1111111 111111111111
