NO ./texture/ray/no.xpm
SO ./texture/ray/so.xpm
WE ./texture/ray/we.xpm
EA ./texture/ray/ea.xpm

F 0,50,0
C 0,100,0
        1111111111111111111111111
        1000000000110000000000001    
        1011000001110000000000001
        1001000000000000000000001
111111111011000001110000000000001
100000000011000001110111100111111
11110111111111011100000000001
11110111111111011100000000001
110000001101010111000111B1111
10000000000000000000010000001
100000000000000000000B00000H1
110000011101010111B101110000111
111101111111010111011110000N1
11111111111111111111111BB1111
         111111111111110011111111
        1000000000110000000000001
        1011000001110000000000001
        1001000000000000000000001
111111111011000001110000000000001
100000000011000001110111100111111
11110111111111011100000000001
11110111111111011100000000001
110000001101010111000111B1111
10000000000000000000010000001
100000000000000000000B00000H1
1100000111010101111101110000111
11110111 1110101 101111000001
11111111 1111111 111111111111