NO ./texture/ray/no.xpm
SO ./texture/ray/so.xpm
WE ./texture/ray/we.xpm
EA ./texture/ray/ea.xpm

F 0,50,0
C 0,100,0

        1111111111111111111111111
        1000000000110000000000001
        1011000001110000000000001
        1001000000000000000000001
111111111011000001110000000000001
1000000000110000011101111BB111111
11110111111111011100000010001
11110111111111011101010000001
11000000110101011100000000001
10000000000000001100000111B11
10000000000000001101010100001
11000001110101011111011100N0111
11110111 1110101 1011110B00H1
11111111 1111111 111111111111
